1111111111111111111111111111111111111111111111111111111111111111111111111111111111111111111111111111
1000000000000000000000000000000000000000000000000000000000000000000000000000000000000000000000000001
1000000000000000000000000000000000000000000000000000000000000000000000000000000000000000000000000001
1000000000000000000000000000000000000000000000000000000000000000000000000000000000000000000000000001
1000000000000000000000000000000000000000000000000000000000000000000000000000000000000000000000000001
1000000000000000000000000000000000000000000000000000000000000000000000000000000000000000000000000021
1000000000000000000000000000000000000000000000000111111111111111111111111111111111111111111111111111
1000000000000000000000000000000000000000000000000111111111111111111111111111111111111111111111111111
1000000000000000000000000000000000000000000000000000000000000000000000000000000000000000000000000001
1000000000000000000000000000000000000000000000000000000000000000000000000000000000000000000000000001
1000000000000000000000000000000000000000000000000000000000000000000000000000000000000000000000000001
1000000000000000000000000000000000000000000000000000000000000000000000000000000000000000000000000001
1000000000000000000000000000011111111110000000000000000000000000000000000000000000000000000000000001
1000000000000000000000000000011111111110000000000000000000000000000000000000000000000000000000000001
1000000000000000000000000000000000000000000000000000000000000000000000000000000000000000000000000001
1000000000000000000000000000000000000000000000000000000000000000000000000000000000000000000000000001
1000000000000000000000000000000000000000000000000000000000000000000000000000000000000000000000000001
1000000000000000000000000000000000000000000000000000000000000000000000000000000000000000000000000001
1000000000000000000000000000000000000000000011111111110000000000000000000000000000000000000000000001
1000000000000000000000000000000000000000000011111111110000000000000000000000000000000000000000000001
1000000000000000000000000000000000000000000000000000000000000000000000000000000000000000000000000001
1000000000000000000000000000000000000000000000000000000000000000000000000000000000000000000000000001
1000000000000000000000000000000000000000000000000000000000000000000000000000000000000000000000000001
1000000000000000000000000000000000000000000000000000000000000000000000000000000000000000000000000001
1000000000000000000000000000000000000000000000000000000000011111111110000000000000000000000000000001
1000000000000000000000000000000000000000000000000000000000011111111110000000000000000000000000000001
1000000000000000000000000000000000000000000000000000000000000000000000000000000000000000000000000001
1000000000000000000000000000000000000000000000000000000000000000000000000000000000000000000000000001
1000000000000000000000000000000000000000000000000000000000000000000000000000000000000000000000000001
1000000000000000000000000000000000000000000000000000000000000000000000000000000000000000000000000001
1000000000000000000000000000000000000000000000000000000000000000000000000011111111110000000000000001
1000000000000000000000000000000000000000000000000000000000000000000000000011111111110000000000000001
1000000000000000000000000000000000000000000000000000000000000000000000000000000000000000000000000001
1000000000000000000000000000000000000000000000000000000000000000000000000000000000000000000000000001
1000000000000000000000000000000000000000000000000000000000000000000000000000000000000000000000000001
1000000000000000000000000000000000000000000000000000000000000000000000000000000000000000000000000001
1000000000000000000000000000000000000000000000000000000000000000000000000000000000000000011111111111
1000000000000000000000000000000000000000000000000000000000000000000000000000000000000000011111111111
1000000000000000000000000000000000000000000000000000000000000000000000000000000000000000000000000001
1000000000000000000000000000000000000000000000000000000000000000000000000000000000000000000000000001
1000000000000000000000000000000000000000000000000000000000000000000000000000000000000000000000000001
1000000000000000000000000000000000000000000000000000000000000000000000000000000000000000000000000001
1000000000000000000000000000000000000000000000000000000000000000000000011111111110000000000000000001
1000000000000000000000000000000000000000000000000000000000000000000000011111111110000000000000000001
1000000000000000000000000000000000000000000000000000000000000000000000011111111110000000000000000001
1000000000000000000000000000000000000000000000000000000000000000000000011111111110000000000000000001
1000000000000000000000000000000000000000000000000001111111111000000000011111111111111100000000000001
1000000000000000000000000000000000000000000000000001111111111000000000011111111111111100000000000001
1000000000000000000000000000000000000000000000000001111111111000000000011111111110000000000000000001
1000000000000000000000000000000000000000000000000001111111111000000000011111111110000000000000000001
1000000000000000000000000000000111111111100000000001111111111111100000011111111110000000000001111111
1000000000000000000000000000000111111111100000000001111111111111100000011111111110000000000001111111
1000000000000000000000000000000111111111100000000001111111111000000000011111111110000000000000000001
1000000000000000000000000000000111111111100000000001111111111000000000011111111110000000000000000001
1000000000011111111110000000000111111111111110000001111111111000000000011111111111111100000000000001
1000000000011111111110000000000111111111111110000001111111111000000111111111111111111100000000000001
1000000000011111111110000000000111111111100000000001111111111000000111111111111110000000000000000001
1000000000011111111110000000000111111111100000000001111111111000000111111111111110000000000000000001
1111111111111111111111111111111111111111111111111111111111111111111111111111111111111111111111111111
1111111111111111111111111111111111111111111111111111111111111111111111111111111111111111111111111111
