1111111111111111111111111111111111111111111111111111111111111111111111111111111111111111111111111111
1000000000000000000000000000000000000000000000000000000000000000000000000000000000000000000000000001
1000000000000000000000000000000000000000000000000000000000000000000000000000000000000000000000000001
1000000000000000000000000000000000000000000000000000000000000000000000000000000000000000000000000001
1000000000000000000000000000000000000000000000000000000000000000000000000000000000000000000000000001
1000000000000000000000000000000000000000000000000000000000000000000000000000000000000000000000000021
1000000000000000000000000000000000000000111111111111111000000000000000111111111111111111111111111111
1000000000000000000000000000000000000000111111111111111000000000000000111111111111111111111111111111
1000000000000000000000000000000000000000000000000000000000000000000000000000000000000000000000000001
1000000000000000000000000000000000000000000000000000000000000000000000000000000000000000000000000001
1000000000000000000000000000000000000000000000000000000000000000000000000000000000000000000000000001
1000000000000000000000000000000000000000000000000000000000000000000000000000000000000000000000000001
1000000000000001111111111111110000000000000000000000000000000000000000000000000000000000000000000001
1000000000000001111111111111110000000000000000000000000000000000000000000000000000000000000000000001
1000000000000000000000000000000000000000000000000000000000000000000000000000000000000000000000000001
1000000000000000000000000000000000000000000000000000000000000000000000000000000000000000000000000001
1000000000000000000000000000000000000000000000000000000000000000000000000000000000000000000000000001
1000000000000000000000000000000000000000000000000000000000000000000000000000000000000000000000000001
1111111111111111111111111111111111111111111111111111111111111111111111111111111111111100000000000001
1000000000000000000000000000000000000000000000000000000000000000000000000000000000111100000000000001
1000000000000000000000000000000000000000000000000000000000000000000000000000000000111100000000000001
1000000000000000000000000000000000000000000000000000000000000000000000000000000000111100000000000001
1000000000000000000000000000000000000000000000000000000000000000000000000000000000111100000000000001
1000000000001111111111111100000000000000000111111111111111111111111111111111111111111100000000000001
1000000000001100000000001100000000000000000000000000000000000000000000000000000000111100000001111111
1000000000001100000000001111111111111000000000000000000000000000000000000000000000111100000001111111
1000000000001100000000000000000000011000000000000000000000000000000000000000000000111100000000000001
1000000000001100000000000000000000011000000000000000000000000000000000000000000000111100000000000001
1000000000001100000000000000000000011111111111111111111111111111111111111110000000111100000000000001
1000000000001100000000000000000000000000000000000000000000000000000000111110000000111100000000000001
1111100000001111111111100000000000000000000000000000000000000000000000111110000000111111111100000001
1111100000000000000001100000000000000000000000000000000000000000000000111110000000111111111100000001
1000000000000000000001100000000000000000000000000000000000000000000000111110000000111100000000000001
1000000000000000000001111111111111111111111111111111111111111111000000111110000000111100000000000001
1000000000000000000000000000000000000000000000000000000000000000000000111110000000111100000000000001
1000000000001100000000000000000000000000000000000000000000000000000000111110000000111100000000000001
1000000000001100000000000000000000000000000000000000000000000000000000111110000000111100000001111111
1000000011111100000000000000000000000000000000000000000000000000000000111110000000111100000001111111
1000000011111111111111111111111111111111111111111111111111111111111111111110000000111100000000000001
1000000000000000000000000000000000000000000000000000000000000000000000111110000000111100000000000001
1000000000000000000000000000000000000000000000000000000000000000000000111110000000111100000000000001
1000000000000000000000000000000000000000000000000000000000000000000000111110000000111100000000000001
1000000000000000000000000000000000000000000000000000000000000000000000111110000000111111111100000001
1111111111111111111111111111111111111111111111111111111111111110000000111110000000111111111100000001
1000000000000000000000000000000000000000000000000000000000000000000000111110000000000000000000000001
1000000000000000000000000000000000000000000000000000000000000000000000111110000000000000000000000001
1000000000000000000000000000000000000000000000000000000000000000000000111110000000000000000000000001
1000000000000000000000000000000000000000000000000000000000000000000000111110000000000000000000000001
1000000000011111111111111111100000000111111111111111111111111111111111111111111111111111111111111111
1000000000000000000011000000000000000000000000000000000000000000000110000000000000000000000000000001
1000000000000000000011000000000000000000000000000000000000000000000110000000000000000000000000000001
1000000000000000000011000000000000000000000000000000000000000000000110000000000000000000000000000001
1000000000000000000011000000000000000000000000000000000000000000000110000000000000000000000000000001
1111111111110000000011111111111111111111111111111111111111111111111111111111111111111111110000000001
1000000000000000000000000000000000000000000000000000000000000000000000000000000000000000000000000001
1000000000000000000000000000000000000000000000000000000000000000000000000000000000000000000000000001
1000000000000000000000000000000000000000000000000000000000000000000000000000000000000000000000000001
1000000000000000000000000000000000000000000000000000000000000000000000000000000000000000000000000001
1111111111111111111111111111111111111111111111111111111111111111111111111111111111111111111111111111
1111111111111111111111111111111111111111111111111111111111111111111111111111111111111111111111111111
