1111111111111111111111111111111111111111111111111111111111111111111111111111111111111111111111111111
1000000000000000011000000000000000000000000000000000000000000000000000000000000000000000000000000001
1000000000000000011000000000000000000000000000000000000000000000000000000000000000000000000000000001
1000000000000000011000000000000000000000000000000000000000000000000000000000000000000000000000000001
1000000000000000011000000000000000000000000000000000000000000000000000000000000000000000000000000001
1000000000000000011000000000000000000000000000000000000000000000000000000000000000000000000000000001
1000000000000000011000000000000000000000000000000000000000000000000000000000000000000000000000000001
1000000000000000011000000000000000000000000000000000000000000000000000000000000000000000000000000001
1200000000000000011000000000000000000000000000000000000000000000000000000000000000000000000000000001
1111111111111111111000000000000000000000000000000000000000000000000000000000000000000000000000000001
1111111111111111111000000000000000000000000000000000000000000000000000000000000000000000000000000001
1000000000000000000000000000000000000000000000000000000000000000000000000000000000000000000000000001
1000000000000000000000000000000000000000000000000000000000000000000000000000000000000000000000000001
1000000000000000000000000000000000000000000000000000000000000000000000000000000000000000000000000001
1000000000000000000000000000000000000000000000000000000000000000000000000000000000000000000000000001
1000000000000000000000000000000000000000000000000000000000000000000000000000000000000000000000000001
1000000000000000000011111111111111111111111111111111111111111111111111111111111111111111110000000001
1000000000000000000011111111111111111111111111111111111111111111111111111111111111111111110000000001
1000000000000000000000000000000000000000000000000000000000000000000001111111111100000000000000000001
1000000000000000000000000000000000000000000000000000000000000000000001111111111100000000000000000001
1000000000000000000000000000000000000000000000000000000000000000000001111111111100000000000000000001
1000000000000000000000000000000000000000000000000000000000000000000001111111111100000000000000000001
1000000000000000000000000000000000000000000000000000000000000000000001111111111100000000000000000001
1111111111111111111111111111111111111111111111111111110000000000000001111111111100000000011111111111
1111111111111111111111111111111111111111111111111111110000000000000001111111111100000000011111111111
1000000000000000000000000000000000000000000000000000000000000000000001111111111100000000000000000001
1000000000000000000000000000000000000000000000000000000000000000000001111111111100000000000000000001
1000000000000000000000000000000000000000000000000000000000000000000001111111111100000000000000000001
1000000000000000000000000000000000000000000000000000000000000000000001111111111100000000000000000001
1000000000000000000000000000000000000000000000000000000000000000000001111111111100000000000000000001
1000000000000000000011111111111111111111111111111111111111111111111111111111111111111111110000000001
1000000000000000000011111111111111111111111111111111111111111111111111111111111111111111100000000001
1000000000000000000000000000000000000000000000000000000000000000000001111111111100000000000000000001
1000000000000000000000000000000000000000000000000000000000000000000001111111111100000000000000000001
1000000000000000000000000000000000000000000000000000000000000000000001111111111100000000000000000001
1000000000000000000000000000000000000000000000000000000000000000000001111111111100000000000000000001
1000000000000000000000000000000000000000000000000000000000000000000001111111111100000000000000000001
1111111111111111111111111111111111111111111111111111110000000000000001111111111100000000011111111111
1111111111111111111111111111111111111111111111111111110000000000000001111111111100000000011111111111
1000000000000000000000000000000000000000000000000000000000000000000001111111111100000000000000000001
1000000000000000000000000000000000000000000000000000000000000000000001111111111100000000000000000001
1000000000000000000000000000000000000000000000000000000000000000000001111111111100000000000000000001
1000000000000000000000000000000000000000000000000000000000000000000001111111111100000000000000000001
1000000000000000000000000000000000000000000000000000000000000000000001111111111100000000000000000001
1000000000000000000001111111111111111111111111111111111111111111111111111111111111111111110000000001
1000000000000000000001111111111111111111111111111111111111111111111111111111111111111111110000000001
1000000000000000000000000000000000000000000000000000000000000000000001111111111100000000000000000001
1000000000000000000000000000000000000000000000000000000000000000000001111111111100000000000000000001
1000000000000000000000000000000000000000000000000000000000000000000001111111111100000000000000000001
1000000000000000000000000000000000000000000000000000000000000000000001111111111100000000000000000001
1000000000000000000000000000000000000000000000000000000000000000000001111111111100000000000000000001
1111111111111111111111111111111111111111111111111111110000000000000001111111111100000000011111111111
1111111111111111111111111111111111111111111111111111110000000000000001111111111100000000011111111111
1000000000000000000000000000000000000000000000000000000000000000000001111111111100000000000000000001
1000000000000000000000000000000000000000000000000000000000000000000001111111111100000000000000000001
1000000000000000000000000000000000000000000000000000000000000000000001111111111100000000000000000001
1000000000000000000000000000000000000000000000000000000000000000000001111111111100000000000000000001
1000000000000000000000000000000000000000000000000000000000000000000001111111111100000000000000000031
1111111111111111111111111111111111111111111111111111111111111111111111111111111111111111111111111111
1111111111111111111111111111111111111111111111111111111111111111111111111111111111111111111111111111
